32
15
13
PPPPPPPPPPPPPPP
PnnnKKnnKnKnKnP
PnPnPnPnPnPnPnP
PnKKKnnKnnnDnnP
PnPnPKPnPKPnPnP
PDnnnnnnKnKnnKP
PKPKPnPDPnPnPKP
PKnnnnKKKnnnKnP
PnPKPnPnPnPnPnP
PKnnnKKDnnKnnKP
PKPnPnPnPKPnPnP
PnnDnnnnnKnKnnP
PPPPPPPPPPPPPPP