15
13
PPPPPPPPPPPPPPP
PHnnnnKnnnKKKnP
PnPnPnPnPnPnPnP
PKKnnnKnKnnKnnP
PnPnPnPnPKPnPnP
PnKnKnnnnnnKKKP
PnPnPnPKPKPnPnP
PnnnKnnnKKKnnnP
PnPnPnPKPnPnPnP
PKKnKKnnnnKnKnP
PnPnPnPnPnPKPnP
PKnnKnKnnnnnnnP
PPPPPPPPPPPPPPP