32
15
13
PPPPPPPPPPPPPPP
PnnnKKnnKnKNKnP
PnPnPnPnPnPnPnP
PnKKKnnKnnnDnnP
PnPnPKPnPKPnPnP
PnnnnnnnKnKnnKP
PKPKPnPDPnPnPKP
PKnnnnKKKnnnKnP
PnPKPnPnPnPnPnP
PKnnnKKDnnKnnKP
PKPnPnPnPKPnPnP
PnnnnnnnnKnKnnP
PPPPPPPPPPPPPPP