32
15
13
PPPPPPPPPPPPPPP
PnnnnnKnnnKKKnP
PnPnPnPnPnPnPnP
PKKnnnKnKnnKnnP
PnPnPnPnPKPnPnP
PnKnKnnnnnnKKKP
PnPnPnPKPKPnPnP
PnnnKnnnKKKnnnP
PDPDPnPKPnPnPnP
PKKnKKnnnnKnKnP
PnPnPDPnPnPKPnP
PKnnKnKnnnnnnnP
PPPPPPPPPPPPPPP