32
15
13
PPPPPPPPPPPPPPP
PnnnnKnnnKKKKnP
PnPnPKPnPnPnPKP
PnnnnnnKnnKKKnP
PKPnPnPKPDPnPnP
PDnnnnnKnnKnnKP
PnPnPKPnPnPnPDP
PKnnnKnnDKKnKnP
PnPnPKPnPnPKPnP
PKnnnnKKnnnnnnP
PnPnPnPnPnPnPnP
PnnKKKnKnnnKnnP
PPPPPPPPPPPPPPP
