32
15
13
PPPPPPPPPPPPPPP
PnnnnKKKnnKKnKP
PnPKPnPnPKPnPKP
PKnKnnnnKKnnKKP
PnPnPnPnPnPDPnP
PnnnnnnnnnnnKnP
PnPnPKPDPnPnPnP
PnnnKDnDnnnKnnP
PnPnPnPKPKPKPnP
PnnnnnnnnnnnnnP
PKPKPnPnPKPnPnP
PKKKnnKnnKnKKnP
PPPPPPPPPPPPPPP