15
15
PPPPPPPPPPPPPPP
PnnnnnKnnnKKKnP
PnPnPnPnPnPnPnP
PKKnnnKnKnnKnnP
PnPnPnPnPKPnPnP
PnKnKnnnnnnKKKP
PnPnPnPKPKPnPnP
PnnnKnnnKKKnnnP
PnPnPnPKPnPnPnP
PKKnKKnnnnKnKnP
PnPnPnPnPnPKPnP
PKnnKnKnnnnnnnP
PPPPPPPPPPPPPPP