MnnnnKnnnKKKn
nPnPnPnPnPnPn
KKnnnKnKnnKnn
nPnPnPnPKPnPn
nKnKnnnnnnKKK
nPnPnPKPKPnPn
nnnKnnnKKKnnn
DPDPnPKPnPnPn
KKnKKnnnnKnKn
nPnPDPnPnPKPn
KnnKnKnnnnnnn