32
15
13
PPPPPPPPPPPPPPP
PnnnnnKKnnKnnnP
PnPnPnPnPnPnPKP
PnnnnnKnKnnnKnP
PnPnPnPnPKPnPDP
PKnDnnnnKKKnnnP
PnPnPKPnPKPnPnP
PnKnnKnDnKnnDnP
PnPnPnPnPKPnPKP
PKnnKnKnKnnKKnP
PnPnPnPnPKPnPnP
PnKKKnKKnnnKnnP
PPPPPPPPPPPPPPP